1111111111111111111111111111
1P00C00C0000C00000000C00C001
11111111110010111111111111C1
1000C000CC000000000000000001
101111111111111111111111C001
1000C00C0000100000C00000C001
11111111111C0011111111111001
100C0000C0001000000C0000C001
101111111111111111111111C001
1C0000C00000C00000000C000001
111C01111111C0111111110C1001
111C011111110C111111110C1001
1C00C00C0000C00000000C0EC001
1111111111111111111111111111
